Year,Team,G,MP,FG,FGA,FG%,3P,3PA,3P,2P,2PA,2P,FT,FTA,FT%,ORB,DRB,TRB,AST,STL,BLK,TOV,PF,PTS
2019,Indiana Pacers*,82,19705,3177,7059,0.45,932,2633,0.354,2245,4426,0.507,1298,1718,0.756,862,2718,3580,2006,608,425,1284,1642,8584
2019,Miami Heat,82,19730,3141,7116,0.441,973,2717,0.358,2168,4399,0.493,1432,1861,0.769,831,2792,3623,1913,612,389,1159,1652,8687
2019,Memphis Grizzlies,82,19880,3083,6836,0.451,951,2639,0.36,2132,4197,0.508,1586,2023,0.784,781,2883,3664,1920,625,402,1249,1758,8703
2019,Utah Jazz*,82,19755,3276,7253,0.452,806,2273,0.355,2470,4980,0.496,1372,1822,0.753,733,2762,3495,1770,695,376,1136,1835,8730
2019,Orlando Magic*,82,19780,3274,7185,0.456,858,2475,0.347,2416,4710,0.513,1336,1717,0.778,739,2922,3661,1892,575,362,1064,1537,8742
2019,Denver Nuggets*,82,19730,3246,7084,0.458,887,2618,0.339,2359,4466,0.528,1372,1822,0.753,799,2685,3484,2016,610,407,1109,1675,8751
2019,Detroit Pistons*,82,19855,3271,6969,0.469,786,2278,0.345,2485,4691,0.53,1470,1947,0.755,747,2834,3581,1940,566,419,1153,1748,8798
2019,Boston Celtics*,82,19780,3239,7222,0.448,944,2748,0.344,2295,4474,0.513,1430,1872,0.764,852,2912,3764,1940,556,317,1241,1602,8852
2019,Toronto Raptors*,82,19880,3302,7352,0.449,882,2559,0.345,2420,4793,0.505,1399,1829,0.765,867,2804,3671,2012,622,368,1225,1683,8885
2019,Houston Rockets*,82,19830,3313,7106,0.466,831,2444,0.34,2482,4662,0.532,1493,1944,0.768,899,2825,3724,1929,607,369,1232,1640,8950
2019,Milwaukee Bucks*,82,19780,3322,7669,0.433,1073,2976,0.361,2249,4693,0.479,1242,1694,0.733,813,2902,3715,2031,557,395,1096,1653,8959
2019,San Antonio Spurs*,82,19805,3404,7354,0.463,961,2678,0.359,2443,4676,0.522,1249,1654,0.755,756,2844,3600,2025,589,332,999,1611,9018
2019,Dallas Mavericks,82,19780,3357,7315,0.459,918,2667,0.344,2439,4648,0.525,1400,1802,0.777,836,2840,3676,2011,643,368,1065,1905,9032
2019,Portland Trail Blazers*,82,19855,3371,7384,0.457,878,2443,0.359,2493,4941,0.505,1438,1868,0.77,842,2670,3512,1906,603,420,1014,1699,9058
2019,Oklahoma City Thunder*,82,19855,3343,7272,0.46,922,2592,0.356,2421,4680,0.517,1500,1971,0.761,811,2936,3747,2039,672,415,1372,1844,9108
2019,Golden State Warriors*,82,19805,3315,7471,0.444,955,2753,0.347,2360,4718,0.5,1535,1987,0.773,886,2750,3636,1989,630,295,1105,1601,9120
2019,Charlotte Hornets,82,19830,3436,7311,0.47,992,2748,0.361,2444,4563,0.536,1307,1660,0.787,825,2931,3756,2133,565,492,1109,1686,9171
2019,Brooklyn Nets*,82,19980,3460,7581,0.456,848,2486,0.341,2612,5095,0.513,1442,1872,0.77,902,2889,3791,1944,638,432,1104,1807,9210
2019,Philadelphia 76ers*,82,19805,3418,7506,0.455,843,2464,0.342,2575,5042,0.511,1545,2011,0.768,823,2743,3566,1917,634,336,1045,1816,9224
2019,Chicago Bulls,82,19905,3464,7316,0.473,990,2709,0.365,2474,4607,0.537,1377,1805,0.763,824,2984,3808,2094,600,473,1092,1534,9295
2019,Los Angeles Lakers,82,19780,3438,7610,0.452,971,2784,0.349,2467,4826,0.511,1459,1862,0.784,924,2918,3842,2053,683,421,1167,1706,9306
2019,New York Knicks,82,19780,3434,7352,0.467,969,2673,0.363,2465,4679,0.527,1493,1948,0.766,881,3016,3897,2098,607,458,1084,1708,9330
2019,Minnesota Timberwolves,82,19830,3452,7386,0.467,1041,2752,0.378,2411,4634,0.52,1401,1827,0.767,921,2822,3743,2145,539,455,1209,1795,9346
2019,Cleveland Cavaliers,82,19755,3539,7148,0.495,984,2590,0.38,2555,4558,0.561,1293,1680,0.77,782,2835,3617,2107,568,459,1022,1592,9355
2019,Los Angeles Clippers*,82,19830,3423,7490,0.457,849,2477,0.343,2574,5013,0.513,1677,2159,0.777,925,2826,3751,1976,677,498,1081,1969,9372
2019,Sacramento Kings,82,19730,3465,7430,0.466,986,2837,0.348,2479,4593,0.54,1539,1998,0.77,917,3015,3932,2024,618,420,1304,1753,9455
2019,New Orleans Pelicans,82,19755,3549,7610,0.466,1006,2766,0.364,2543,4844,0.525,1471,1926,0.764,898,2855,3753,2174,702,445,1113,1722,9575
2019,Phoenix Suns,82,19880,3482,7230,0.482,912,2454,0.372,2570,4776,0.538,1705,2263,0.753,971,2897,3868,2126,737,411,1285,1694,9581
2019,Washington Wizards,82,19930,3560,7424,0.48,994,2689,0.37,2566,4735,0.542,1474,1895,0.778,936,2939,3875,2151,631,378,1292,1741,9588
2019,Atlanta Hawks,82,19855,3508,7417,0.473,1013,2820,0.359,2495,4597,0.543,1759,2321,0.758,871,2904,3775,2202,810,448,1234,1817,9788
2018,Utah Jazz*,82,19755,3057,6804,0.449,778,2131,0.365,2279,4673,0.488,1295,1680,0.771,710,2702,3412,1636,678,380,1224,1683,8187
2018,San Antonio Spurs*,82,19730,3131,6911,0.453,750,2154,0.348,2381,4757,0.501,1175,1549,0.759,756,2731,3487,1786,622,318,1155,1619,8187
2018,Boston Celtics*,82,19805,3066,6973,0.44,769,2270,0.339,2297,4703,0.488,1334,1748,0.763,791,2804,3595,1744,594,364,1159,1571,8235
2018,Miami Heat*,82,19930,3090,6873,0.45,785,2181,0.36,2305,4692,0.491,1476,1885,0.783,744,2791,3535,1720,616,378,1160,1587,8441
2018,Portland Trail Blazers*,82,19755,3146,7042,0.447,794,2179,0.364,2352,4863,0.484,1362,1803,0.755,763,2755,3518,1655,602,418,1036,1564,8448
2018,Toronto Raptors*,82,19830,3149,7017,0.449,731,2046,0.357,2418,4971,0.486,1489,1941,0.767,806,2672,3478,1785,588,401,1176,1633,8518
2018,Houston Rockets*,82,19755,3244,7017,0.462,829,2365,0.351,2415,4652,0.519,1201,1610,0.746,710,2738,3448,1837,609,363,1194,1670,8518
2018,Detroit Pistons,82,19805,3206,6988,0.459,908,2527,0.359,2298,4461,0.515,1201,1548,0.776,756,2833,3589,2064,597,398,1215,1511,8521
2018,Indiana Pacers*,82,19755,3230,6953,0.465,870,2496,0.349,2360,4457,0.53,1213,1602,0.757,838,2686,3524,1905,577,428,1271,1514,8543
2018,Oklahoma City Thunder*,82,19830,3156,6885,0.458,920,2507,0.367,2236,4378,0.511,1332,1733,0.769,781,2676,3457,1911,630,377,1315,1750,8564
2018,Philadelphia 76ers*,82,19780,3120,7185,0.434,829,2427,0.342,2291,4758,0.482,1566,2102,0.745,818,2641,3459,1782,697,417,1173,1670,8635
2018,Dallas Mavericks,82,19805,3219,6870,0.469,874,2411,0.363,2345,4459,0.526,1327,1754,0.757,725,3027,3752,1929,594,369,1127,1604,8639
2018,Memphis Grizzlies,82,19705,3046,6587,0.462,874,2377,0.368,2172,4210,0.516,1688,2196,0.769,782,2703,3485,1816,662,421,1210,1674,8654
2018,Sacramento Kings,82,19755,3177,6759,0.47,976,2586,0.377,2201,4173,0.527,1347,1760,0.765,745,2843,3588,1939,636,389,1176,1422,8677
2018,Washington Wizards*,82,19855,3195,6918,0.462,835,2393,0.349,2360,4525,0.522,1469,1931,0.761,805,2682,3487,1831,641,383,1224,1639,8694
2018,Milwaukee Bucks*,82,19830,3209,6864,0.468,829,2226,0.372,2380,4638,0.513,1509,1926,0.783,817,2686,3503,1939,585,366,1279,1633,8756
2018,Minnesota Timberwolves*,82,19805,3298,6942,0.475,890,2431,0.366,2408,4511,0.534,1311,1683,0.779,803,2626,3429,1962,529,382,1239,1711,8797
2018,Golden State Warriors*,82,19730,3296,7380,0.447,853,2392,0.357,2443,4988,0.49,1369,1807,0.758,893,2592,3485,1934,717,301,1175,1516,8814
2018,Charlotte Hornets,82,19780,3370,7199,0.468,926,2467,0.375,2444,4732,0.516,1187,1494,0.795,692,2891,3583,2029,542,404,1112,1839,8853
2018,New York Knicks,82,19830,3233,7078,0.457,917,2494,0.368,2316,4584,0.505,1475,1906,0.774,838,2702,3540,1965,670,389,1096,1509,8858
2018,Orlando Magic,82,19730,3355,7176,0.468,819,2260,0.362,2536,4916,0.516,1345,1741,0.773,868,2892,3760,1998,639,402,1166,1556,8874
2018,Denver Nuggets,82,19880,3386,7113,0.476,893,2364,0.378,2493,4749,0.525,1234,1671,0.738,800,2613,3413,2028,654,391,1131,1699,8899
2018,Atlanta Hawks,82,19705,3336,7107,0.469,949,2519,0.377,2387,4588,0.52,1301,1686,0.772,841,2785,3626,2137,710,453,1238,1661,8922
2018,Los Angeles Clippers,82,19705,3298,7194,0.458,881,2477,0.356,2417,4717,0.512,1457,1864,0.782,871,2706,3577,2015,699,462,1154,1803,8934
2018,Los Angeles Lakers,82,19905,3366,7374,0.456,855,2469,0.346,2511,4905,0.512,1402,1843,0.761,840,2835,3675,1932,682,447,1170,1679,8989
2018,Cleveland Cavaliers*,82,19730,3429,7238,0.474,956,2596,0.368,2473,4642,0.533,1200,1588,0.756,812,2766,3578,2122,613,340,1105,1696,9014
2018,Chicago Bulls,82,19855,3360,7115,0.472,990,2678,0.37,2370,4437,0.534,1307,1660,0.787,691,3053,3744,2123,588,423,1112,1425,9017
2018,Brooklyn Nets,82,19855,3418,7334,0.466,741,2010,0.369,2677,5324,0.503,1471,1921,0.766,853,2981,3834,1782,630,450,1015,1615,9048
2018,New Orleans Pelicans*,82,19955,3423,7539,0.454,891,2509,0.355,2532,5030,0.503,1317,1679,0.784,887,2843,3730,1947,670,344,1186,1669,9054
2018,Phoenix Suns,82,19705,3426,7274,0.471,895,2398,0.373,2531,4876,0.519,1543,2014,0.766,855,2906,3761,1910,712,488,1099,1715,9290
2017,Utah Jazz*,82,19755,2978,6723,0.443,671,1874,0.358,2307,4849,0.476,1308,1701,0.769,742,2554,3296,1463,598,312,995,1655,7935
2017,San Antonio Spurs*,82,19805,3032,6839,0.443,668,1942,0.344,2364,4897,0.483,1315,1705,0.771,800,2600,3400,1757,614,333,1184,1623,8047
2017,Memphis Grizzlies*,82,19905,2864,6465,0.443,813,2299,0.354,2051,4166,0.492,1658,2202,0.753,761,2692,3453,1645,574,410,1171,1708,8199
2017,Dallas Mavericks,82,19780,3035,6477,0.469,788,2074,0.38,2247,4403,0.51,1411,1827,0.772,727,2923,3650,1743,535,280,1225,1591,8269
2017,Miami Heat,82,19780,3108,6904,0.45,639,1864,0.343,2469,5040,0.49,1518,1940,0.782,837,2737,3574,1611,556,398,1121,1530,8373
2017,Chicago Bulls*,82,19780,3236,7099,0.456,731,2121,0.345,2505,4978,0.503,1197,1555,0.77,843,2698,3541,1939,602,378,1100,1541,8400
2017,Detroit Pistons,82,19805,3144,6830,0.46,767,2098,0.366,2377,4732,0.502,1346,1726,0.78,656,2861,3517,1929,551,339,1046,1434,8401
2017,Toronto Raptors*,82,19780,3052,6801,0.449,794,2240,0.354,2258,4561,0.495,1519,1948,0.78,831,2619,3450,1786,547,392,1200,1666,8417
2017,Milwaukee Bucks*,82,19780,3116,6802,0.458,816,2312,0.353,2300,4490,0.512,1464,1900,0.771,845,2636,3481,1974,609,375,1205,1579,8512
2017,Atlanta Hawks*,82,19880,3178,7155,0.444,893,2502,0.357,2285,4653,0.491,1280,1658,0.772,876,2722,3598,1919,738,424,1262,1768,8529
2017,Golden State Warriors*,82,19780,3181,7311,0.435,737,2277,0.324,2444,5034,0.485,1450,1905,0.761,963,2604,3567,1862,705,313,1272,1588,8549
2017,Los Angeles Clippers*,82,19755,3163,6999,0.452,753,2154,0.35,2410,4845,0.497,1480,1917,0.772,837,2700,3537,1891,577,258,1084,1835,8559
2017,Charlotte Hornets,82,19830,3237,7092,0.456,950,2576,0.369,2287,4516,0.506,1161,1496,0.776,732,2909,3641,2012,539,450,1071,1631,8585
2017,Indiana Pacers*,82,19855,3115,6909,0.451,849,2389,0.355,2266,4520,0.501,1557,1974,0.789,879,2751,3630,1832,661,407,1225,1599,8636
2017,Boston Celtics*,82,19755,3168,7035,0.45,735,2213,0.332,2433,4822,0.505,1570,2042,0.769,883,2769,3652,1851,623,425,1141,1664,8641
2017,Oklahoma City Thunder*,82,19805,3215,6998,0.459,724,2036,0.356,2491,4962,0.502,1525,1996,0.764,750,2583,3333,1758,698,450,1129,1697,8679
2017,New Orleans Pelicans,82,19905,3286,7299,0.45,863,2445,0.353,2423,4854,0.499,1293,1697,0.762,872,3091,3963,1921,603,348,1144,1581,8728
2017,Minnesota Timberwolves,82,19805,3246,6829,0.475,811,2213,0.366,2435,4616,0.528,1445,1881,0.768,806,2508,3314,1896,629,413,1169,1681,8748
2017,Sacramento Kings,82,19880,3153,6824,0.462,896,2462,0.364,2257,4362,0.517,1546,1988,0.778,826,2689,3515,1941,694,420,1145,1646,8748
2017,Cleveland Cavaliers*,82,19880,3333,7284,0.458,850,2353,0.361,2483,4931,0.504,1271,1644,0.773,902,2724,3626,2024,598,349,1033,1690,8787
2017,Washington Wizards*,82,19855,3253,6978,0.466,810,2224,0.364,2443,4754,0.514,1489,1982,0.751,868,2661,3529,1870,606,377,1257,1621,8805
2017,Orlando Magic,82,19805,3304,7081,0.467,794,2161,0.367,2510,4920,0.51,1425,1860,0.766,799,2934,3733,1936,622,419,1069,1532,8827
2017,New York Knicks,82,19855,3259,7163,0.455,806,2313,0.348,2453,4850,0.506,1533,1988,0.771,953,2715,3668,1786,615,377,1060,1516,8857
2017,Philadelphia 76ers,82,19830,3244,7043,0.461,729,2044,0.357,2515,4999,0.503,1650,2135,0.773,886,2802,3688,1859,704,446,1241,1610,8867
2017,Portland Trail Blazers*,82,19930,3213,7069,0.455,762,2058,0.37,2451,5011,0.489,1706,2173,0.785,830,2778,3608,1688,633,431,1052,1624,8894
2017,Houston Rockets*,82,19780,3375,7286,0.463,820,2389,0.343,2555,4897,0.522,1415,1819,0.778,878,2735,3613,1979,697,409,1235,1674,8985
2017,Denver Nuggets,82,19755,3454,7248,0.477,808,2153,0.375,2646,5095,0.519,1403,1794,0.782,770,2576,3346,1972,681,404,982,1653,9119
2017,Los Angeles Lakers,82,19705,3405,7053,0.483,830,2245,0.37,2575,4808,0.536,1499,1966,0.762,843,2801,3644,2110,698,440,1188,1520,9139
2017,Brooklyn Nets,82,19755,3414,7449,0.458,816,2232,0.366,2598,5217,0.498,1581,2049,0.772,902,2965,3867,1888,780,457,1092,1671,9225
2017,Phoenix Suns,82,19830,3300,7070,0.467,825,2159,0.382,2475,4911,0.504,1868,2387,0.783,840,2772,3612,1818,663,435,1222,1822,9293
2016,San Antonio Spurs*,82,19705,2928,6709,0.436,541,1634,0.331,2387,5075,0.47,1221,1611,0.758,747,2576,3323,1707,592,317,1214,1597,7618
2016,Utah Jazz,82,19955,2920,6549,0.446,649,1819,0.357,2271,4730,0.48,1374,1842,0.746,764,2522,3286,1568,652,385,1146,1629,7863
2016,Toronto Raptors*,82,19780,2991,6732,0.444,717,1922,0.373,2274,4810,0.473,1354,1809,0.748,782,2561,3343,1781,534,442,1094,1801,8053
2016,Cleveland Cavaliers*,82,19855,3019,6736,0.448,647,1862,0.347,2372,4874,0.487,1378,1855,0.743,760,2604,3364,1756,590,362,1092,1690,8063
2016,Miami Heat*,82,19830,3054,6914,0.442,605,1742,0.347,2449,5172,0.474,1356,1761,0.77,803,2580,3383,1657,612,337,1060,1608,8069
2016,Atlanta Hawks*,82,19830,3046,7058,0.432,679,2008,0.338,2367,5050,0.469,1366,1810,0.755,944,2869,3813,1808,706,411,1324,1500,8137
2016,Los Angeles Clippers*,82,19830,3015,6946,0.434,645,1909,0.338,2370,5037,0.471,1543,2055,0.751,968,2861,3829,1740,583,259,1260,1842,8218
2016,Indiana Pacers*,82,19880,3065,6962,0.44,679,2035,0.334,2386,4927,0.484,1428,1901,0.751,877,2774,3651,1707,634,366,1297,1676,8237
2016,Charlotte Hornets*,82,19855,3098,6971,0.444,726,2081,0.349,2372,4890,0.485,1334,1735,0.769,726,2936,3662,1901,553,448,1103,1670,8256
2016,New York Knicks,82,19805,3114,7035,0.443,626,1838,0.341,2488,5197,0.479,1435,1904,0.754,890,2733,3623,1703,589,343,927,1520,8289
2016,Memphis Grizzlies*,82,19830,2947,6459,0.456,797,2185,0.365,2150,4274,0.503,1619,2107,0.768,830,2711,3541,1792,576,469,1328,1732,8310
2016,Detroit Pistons*,82,19880,3182,6903,0.461,596,1679,0.355,2586,5224,0.495,1351,1726,0.783,725,2763,3488,1766,583,366,1099,1773,8311
2016,Boston Celtics*,82,19780,3075,6973,0.441,643,1912,0.336,2432,5061,0.481,1613,2136,0.755,932,2838,3770,1715,622,450,1348,1718,8406
2016,Dallas Mavericks*,82,20005,3144,6971,0.451,743,2170,0.342,2401,4801,0.5,1382,1873,0.738,868,2887,3755,1800,617,363,1142,1757,8413
2016,Oklahoma City Thunder*,82,19830,3150,7192,0.438,667,1949,0.342,2483,5243,0.474,1474,1950,0.756,923,2373,3296,1767,719,373,1068,1653,8441
2016,Chicago Bulls,82,19905,3234,7333,0.441,651,1885,0.345,2583,5448,0.474,1337,1813,0.737,969,2798,3767,1848,655,465,974,1535,8456
2016,Milwaukee Bucks,82,19830,3097,6817,0.454,765,2171,0.352,2332,4646,0.502,1506,1961,0.768,942,2583,3525,2013,679,462,1269,1600,8465
2016,Orlando Magic,82,19905,3150,6850,0.46,732,2041,0.359,2418,4809,0.503,1470,1971,0.746,832,2800,3632,1899,620,448,1240,1497,8502
2016,Golden State Warriors*,82,19880,3188,7330,0.435,640,1928,0.332,2548,5402,0.472,1523,2013,0.757,937,2662,3599,1823,710,336,1185,1627,8539
2016,Portland Trail Blazers*,82,19805,3146,6945,0.453,700,1888,0.371,2446,5057,0.484,1562,2129,0.734,867,2716,3583,1770,630,424,1088,1597,8554
2016,Washington Wizards,82,19755,3170,6868,0.462,737,1987,0.371,2433,4881,0.498,1498,1947,0.769,773,2858,3631,1846,661,356,1325,1651,8575
2016,Denver Nuggets,82,19830,3182,6904,0.461,754,2033,0.371,2428,4871,0.498,1491,1958,0.761,799,2700,3499,1924,660,517,1122,1712,8609
2016,Minnesota Timberwolves,82,19880,3276,6962,0.471,742,2089,0.355,2534,4873,0.52,1394,1842,0.757,877,2558,3435,1857,638,427,1220,1768,8688
2016,Brooklyn Nets,82,19755,3345,6984,0.479,775,2100,0.369,2570,4884,0.526,1227,1608,0.763,840,2719,3559,2006,720,430,1162,1510,8692
2016,Houston Rockets*,82,19830,3200,6977,0.459,796,2206,0.361,2404,4771,0.504,1525,2018,0.756,970,2690,3660,2015,734,404,1360,1847,8721
2016,New Orleans Pelicans,82,19780,3218,6877,0.468,754,2043,0.369,2464,4834,0.51,1544,1972,0.783,730,2912,3642,1899,602,423,1127,1630,8734
2016,Los Angeles Lakers,82,19730,3323,7023,0.473,700,2016,0.347,2623,5007,0.524,1420,1942,0.731,897,2915,3812,2022,617,458,1037,1573,8766
2016,Phoenix Suns,82,19705,3208,6870,0.467,770,2041,0.377,2438,4829,0.505,1631,2177,0.749,813,2770,3583,1837,782,449,1224,1770,8817
2016,Philadelphia 76ers,82,19805,3253,7005,0.464,638,1776,0.359,2615,5229,0.5,1683,2141,0.786,913,2987,3900,1919,711,466,1241,1571,8827
2016,Sacramento Kings,82,19805,3327,7194,0.462,839,2293,0.366,2488,4901,0.508,1450,1902,0.762,926,2765,3691,1986,722,437,1308,1800,8943
2015,Utah Jazz,82,19705,2935,6587,0.446,604,1670,0.362,2331,4917,0.474,1309,1760,0.744,811,2406,3217,1594,674,382,1076,1604,7783
2015,Memphis Grizzlies*,82,19905,2954,6684,0.442,663,1889,0.351,2291,4795,0.478,1225,1651,0.742,864,2616,3480,1652,604,424,1257,1662,7796
2015,San Antonio Spurs*,82,19955,3044,6861,0.444,558,1550,0.36,2486,5311,0.468,1307,1754,0.745,813,2643,3456,1699,648,362,1167,1613,7953
2015,Indiana Pacers,82,19855,2949,6784,0.435,591,1713,0.345,2358,5071,0.465,1469,1951,0.753,800,2704,3504,1633,617,386,1045,1754,7958
2015,Atlanta Hawks*,82,19730,2991,6815,0.439,720,2112,0.341,2271,4703,0.483,1262,1651,0.764,948,2631,3579,1931,604,404,1317,1611,7964
2015,Miami Heat,82,19730,2960,6523,0.454,666,1887,0.353,2294,4636,0.495,1391,1905,0.73,894,2467,3361,1748,646,359,1215,1715,7977
2015,Charlotte Hornets,82,19905,3020,6863,0.44,649,1816,0.357,2371,5047,0.47,1292,1673,0.772,728,2890,3618,1815,502,440,1033,1708,7981
2015,Milwaukee Bucks*,82,19930,2917,6681,0.437,676,1974,0.342,2241,4707,0.476,1478,1993,0.742,938,2576,3514,1831,708,392,1425,1649,7988
2015,Chicago Bulls*,82,19880,3095,7109,0.435,538,1605,0.335,2557,5504,0.465,1291,1723,0.749,963,2598,3561,1657,614,443,1000,1736,8019
2015,Washington Wizards*,82,19955,2965,6844,0.433,657,1885,0.349,2308,4959,0.465,1434,1942,0.738,821,2599,3420,1634,655,350,1145,1610,8021
2015,New Orleans Pelicans*,82,19780,3108,6814,0.456,537,1605,0.335,2571,5209,0.494,1329,1751,0.759,870,2537,3407,1700,555,475,1003,1533,8082
2015,Portland Trail Blazers*,82,19855,3130,7123,0.439,524,1552,0.338,2606,5571,0.468,1298,1713,0.758,902,2754,3656,1669,655,297,999,1534,8082
2015,Cleveland Cavaliers*,82,19780,3121,6850,0.456,634,1848,0.343,2487,5002,0.497,1214,1629,0.745,885,2487,3372,1974,642,368,1092,1685,8090
2015,Detroit Pistons,82,19830,3106,6817,0.456,635,1789,0.355,2471,5028,0.491,1312,1699,0.772,877,2740,3617,1949,572,391,1146,1584,8159
2015,Golden State Warriors*,82,19730,3031,7084,0.428,592,1757,0.337,2439,5327,0.458,1534,2011,0.763,963,2690,3653,1718,680,293,1329,1541,8188
2015,Los Angeles Clippers*,82,19730,2984,6745,0.442,683,1959,0.349,2301,4786,0.481,1560,2105,0.741,868,2649,3517,1904,548,245,1171,1766,8211
2015,Houston Rockets*,82,19805,3092,6983,0.443,605,1881,0.322,2487,5102,0.487,1451,1932,0.751,973,2621,3594,1752,726,437,1342,1730,8240
2015,Brooklyn Nets*,82,19930,3150,6913,0.456,696,1944,0.358,2454,4969,0.494,1278,1748,0.731,937,2699,3636,1944,643,372,1137,1641,8274
2015,Toronto Raptors*,82,19855,3116,6787,0.459,633,1828,0.346,2483,4959,0.501,1410,1923,0.733,922,2559,3481,1870,567,413,1182,1668,8275
2015,Philadelphia 76ers,82,19805,3045,6785,0.449,658,1879,0.35,2387,4906,0.487,1530,2023,0.756,940,2853,3793,1942,779,454,1374,1657,8278
2015,Boston Celtics*,82,19880,3125,6943,0.45,607,1804,0.336,2518,5139,0.49,1442,1909,0.755,893,2772,3665,1798,583,431,1239,1545,8299
2015,New York Knicks,82,19855,3031,6592,0.46,694,1825,0.38,2337,4767,0.49,1543,2032,0.759,898,2669,3567,1783,659,353,1153,1564,8299
2015,Orlando Magic,82,19755,3112,6720,0.463,682,1853,0.368,2430,4867,0.499,1410,1878,0.751,825,2739,3564,1921,635,441,1185,1467,8316
2015,Oklahoma City Thunder,82,19830,3085,7008,0.44,681,1984,0.343,2404,5024,0.479,1494,2005,0.745,917,2587,3504,1815,642,377,1118,1675,8345
2015,Dallas Mavericks*,82,19880,3117,6930,0.45,741,2034,0.364,2376,4896,0.485,1415,1879,0.753,1006,2778,3784,1830,602,314,1339,1816,8390
2015,Phoenix Suns,82,19880,3149,6972,0.452,633,1798,0.352,2516,5174,0.486,1540,2030,0.759,951,2766,3717,1734,651,337,1276,1664,8471
2015,Denver Nuggets,82,19880,3164,6909,0.458,631,1823,0.346,2533,5086,0.498,1652,2208,0.748,899,2798,3697,1894,611,504,1177,1698,8611
2015,Sacramento Kings,82,19855,3238,7094,0.456,718,2055,0.349,2520,5039,0.5,1420,1898,0.748,898,2479,3377,1912,712,508,1059,1958,8614
2015,Los Angeles Lakers,82,19930,3180,6817,0.466,697,1921,0.363,2483,4896,0.507,1577,2118,0.745,824,2797,3621,1966,611,396,1068,1589,8634
2015,Minnesota Timberwolves,82,19805,3373,6933,0.487,697,1897,0.367,2676,5036,0.531,1294,1704,0.759,953,2619,3572,1933,686,449,1243,1751,8737
2014,Chicago Bulls*,82,19930,2867,6660,0.43,538,1532,0.351,2329,5128,0.454,1256,1668,0.753,876,2508,3384,1604,621,490,1178,1714,7528
2014,Indiana Pacers*,82,19780,2850,6785,0.42,538,1561,0.345,2312,5224,0.443,1334,1768,0.755,855,2521,3376,1525,593,378,1120,1793,7572
2014,Memphis Grizzlies*,82,19805,2924,6500,0.45,615,1731,0.355,2309,4769,0.484,1292,1686,0.766,809,2403,3212,1632,591,410,1162,1553,7755
2014,Charlotte Bobcats*,82,19905,3022,6838,0.442,665,1800,0.369,2357,5038,0.468,1251,1649,0.759,785,2766,3551,1718,514,415,1090,1716,7960
2014,Miami Heat*,82,19880,2961,6475,0.457,694,1917,0.362,2267,4558,0.497,1374,1832,0.75,886,2420,3306,1751,667,256,1369,1675,7990
2014,San Antonio Spurs*,82,19755,3096,6976,0.444,529,1500,0.353,2567,5476,0.469,1285,1691,0.76,862,2600,3462,1669,628,379,1137,1585,8006
2014,Toronto Raptors*,82,19955,2957,6573,0.45,568,1578,0.36,2389,4995,0.478,1557,2071,0.752,854,2505,3359,1719,596,352,1224,1815,8039
2014,New York Knicks,82,19855,2934,6401,0.458,713,1921,0.371,2221,4480,0.496,1568,2050,0.765,843,2600,3443,1618,513,277,1193,1611,8149
2014,Washington Wizards*,82,20055,3038,6632,0.458,612,1763,0.347,2426,4869,0.498,1462,1912,0.765,827,2633,3460,1824,631,320,1314,1600,8150
2014,Golden State Warriors*,82,19830,3019,6920,0.436,569,1656,0.344,2450,5264,0.465,1548,2023,0.765,878,2671,3549,1683,649,342,1232,1584,8155
2014,Brooklyn Nets*,82,19880,2980,6511,0.458,662,1802,0.367,2318,4709,0.492,1539,2026,0.76,921,2594,3515,1723,608,337,1296,1704,8161
2014,Oklahoma City Thunder*,82,19805,2984,6842,0.436,705,1968,0.358,2279,4874,0.468,1512,2080,0.727,900,2456,3356,1785,669,296,1248,1672,8185
2014,Boston Celtics,82,19730,3101,6675,0.465,539,1553,0.347,2562,5122,0.5,1517,1993,0.761,871,2596,3467,1813,609,373,1168,1564,8258
2014,Los Angeles Clippers*,82,19755,3068,6958,0.441,595,1791,0.332,2473,5167,0.479,1547,2049,0.755,1011,2575,3586,1908,570,284,1261,1919,8278
2014,Atlanta Hawks*,82,19830,3163,6843,0.462,654,1793,0.365,2509,5050,0.497,1341,1793,0.748,882,2688,3570,1901,672,354,1247,1643,8321
2014,Cleveland Cavaliers,82,19930,3097,6847,0.452,765,2083,0.367,2332,4764,0.49,1365,1803,0.757,841,2648,3489,2037,587,461,1144,1599,8324
2014,Orlando Magic,82,19955,3126,6861,0.456,659,1778,0.371,2467,5083,0.485,1449,1881,0.77,859,2746,3605,1848,581,445,1146,1500,8360
2014,Utah Jazz,82,19780,3138,6639,0.473,599,1591,0.376,2539,5048,0.503,1504,1945,0.773,846,2640,3486,1788,617,401,1034,1673,8379
2014,New Orleans Pelicans,82,19855,3055,6567,0.465,652,1827,0.357,2403,4740,0.507,1637,2176,0.752,881,2538,3419,1845,577,504,1185,1664,8399
2014,Dallas Mavericks*,82,19830,3096,6673,0.464,678,1888,0.359,2418,4785,0.505,1530,2019,0.758,943,2569,3512,1808,635,288,1312,1633,8400
2014,Phoenix Suns,82,19755,3118,6840,0.456,556,1632,0.341,2562,5208,0.492,1621,2115,0.766,926,2586,3512,1664,613,332,1258,1749,8413
2014,Portland Trail Blazers*,82,19855,3248,7203,0.451,534,1504,0.355,2714,5699,0.476,1396,1822,0.766,944,2622,3566,1675,639,304,985,1698,8426
2014,Houston Rockets*,82,19830,3197,7218,0.443,666,1889,0.353,2531,5329,0.475,1395,1844,0.757,977,2439,3416,1821,704,460,1149,1993,8455
2014,Sacramento Kings,82,19830,3103,6734,0.461,696,1833,0.38,2407,4901,0.491,1577,2139,0.737,813,2568,3381,1927,637,459,1116,1897,8479
2014,Milwaukee Bucks,82,19880,3146,6722,0.468,697,1826,0.382,2449,4896,0.5,1511,2011,0.751,961,2608,3569,1870,640,413,1158,1690,8500
2014,Minnesota Timberwolves,82,19855,3321,7048,0.471,663,1820,0.364,2658,5228,0.508,1244,1645,0.756,908,2717,3625,1875,644,457,1346,1936,8549
2014,Detroit Pistons,82,19780,3208,6820,0.47,683,1872,0.365,2525,4948,0.51,1487,1967,0.756,913,2612,3525,2001,670,403,1230,1699,8586
2014,Denver Nuggets,82,19755,3238,7086,0.457,605,1724,0.351,2633,5362,0.491,1654,2168,0.763,930,2665,3595,1843,694,459,1178,1778,8735
2014,Los Angeles Lakers,82,19705,3440,7350,0.468,666,1843,0.361,2774,5507,0.504,1412,1942,0.727,1068,2950,4018,2112,790,387,1164,1580,8958
2014,Philadelphia 76ers,82,19855,3284,6975,0.471,739,1998,0.37,2545,4977,0.511,1705,2261,0.754,976,2871,3847,2144,736,558,1391,1686,9012
2013,Memphis Grizzlies*,82,19805,2748,6312,0.435,504,1489,0.338,2244,4823,0.465,1319,1763,0.748,845,2359,3204,1599,600,450,1268,1643,7319
2013,Indiana Pacers*,81,19590,2797,6657,0.42,440,1344,0.327,2357,5313,0.444,1314,1728,0.76,909,2401,3310,1555,611,459,1096,1777,7348
2013,Chicago Bulls*,82,19830,2906,6565,0.443,453,1309,0.346,2453,5256,0.467,1350,1826,0.739,901,2469,3370,1545,600,477,1123,1609,7615
2013,Los Angeles Clippers*,82,19730,2834,6397,0.443,627,1682,0.373,2207,4715,0.468,1465,1956,0.749,891,2315,3206,1812,606,335,1319,1712,7760
2013,Miami Heat*,82,19880,2919,6633,0.44,624,1783,0.35,2295,4850,0.473,1329,1735,0.766,921,2369,3290,1655,649,262,1280,1673,7791
2013,Brooklyn Nets*,82,19855,3066,6614,0.464,518,1415,0.366,2548,5199,0.49,1148,1571,0.731,878,2336,3214,1756,614,390,1102,1751,7798
2013,Boston Celtics*,81,19840,2926,6639,0.441,550,1610,0.342,2376,5029,0.472,1434,1937,0.74,925,2603,3528,1752,634,378,1239,1574,7836
2013,New York Knicks*,82,19730,2916,6365,0.458,639,1789,0.357,2277,4576,0.498,1378,1821,0.757,824,2591,3415,1580,523,327,1242,1576,7849
2013,Washington Wizards,82,19855,2944,6697,0.44,586,1680,0.349,2358,5017,0.47,1378,1867,0.738,903,2719,3622,1767,639,358,1193,1569,7852
2013,Philadelphia 76ers,82,19755,3017,6643,0.454,549,1574,0.349,2468,5069,0.487,1331,1752,0.76,903,2704,3607,1870,590,396,1175,1331,7914
2013,Oklahoma City Thunder*,82,19830,2966,6972,0.425,610,1761,0.346,2356,5211,0.452,1372,1773,0.774,987,2350,3337,1681,673,322,1212,1698,7914
2013,San Antonio Spurs*,82,19880,3079,6960,0.442,519,1471,0.353,2560,5489,0.466,1246,1639,0.76,912,2577,3489,1756,675,405,1221,1565,7923
2013,Atlanta Hawks*,82,19855,3073,6823,0.45,620,1635,0.379,2453,5188,0.473,1233,1617,0.763,928,2659,3587,1825,689,350,1249,1543,7999
2013,New Orleans Hornets,82,19780,3030,6435,0.471,632,1688,0.374,2398,4747,0.505,1339,1764,0.759,835,2391,3226,1915,648,492,1086,1534,8031
2013,Minnesota Timberwolves,82,19730,3113,6657,0.468,576,1559,0.369,2537,5098,0.498,1243,1652,0.752,871,2583,3454,1832,661,481,1302,1847,8045
2013,Utah Jazz,82,19880,3003,6550,0.458,560,1513,0.37,2443,5037,0.485,1479,1953,0.757,901,2446,3347,1689,640,480,1206,1670,8045
2013,Toronto Raptors,82,19980,2971,6493,0.458,546,1511,0.361,2425,4982,0.487,1604,2148,0.747,877,2544,3421,1796,578,387,1169,1650,8092
2013,Detroit Pistons,82,19805,3056,6655,0.459,604,1676,0.36,2452,4979,0.492,1389,1823,0.762,911,2514,3425,1837,691,472,1126,1630,8105
2013,Golden State Warriors*,82,19805,3051,6954,0.439,657,1896,0.347,2394,5058,0.473,1464,1958,0.748,907,2596,3503,1931,670,399,1110,1571,8223
2013,Milwaukee Bucks*,82,19830,3152,6946,0.454,529,1519,0.348,2623,5427,0.483,1398,1841,0.759,1019,2757,3776,1893,658,362,1310,1567,8231
2013,Portland Trail Blazers,82,19855,3224,6807,0.474,521,1531,0.34,2703,5276,0.512,1286,1690,0.761,901,2578,3479,1944,691,359,1074,1537,8255
2013,Los Angeles Lakers*,82,19755,3253,7180,0.453,613,1718,0.357,2640,5462,0.483,1167,1594,0.732,947,2551,3498,1918,696,396,1061,1891,8286
2013,Denver Nuggets*,82,19905,3121,7025,0.444,687,1894,0.363,2434,5131,0.474,1358,1858,0.731,1020,2391,3411,1936,658,554,1305,1775,8287
2013,Orlando Magic,82,19780,3169,6842,0.463,617,1721,0.359,2552,5121,0.498,1336,1811,0.738,888,2618,3506,1946,592,430,1020,1353,8291
2013,Cleveland Cavaliers,82,19730,3109,6527,0.476,610,1639,0.372,2499,4888,0.511,1469,1987,0.739,889,2563,3452,1963,624,560,1249,1615,8297
2013,Phoenix Suns,82,19805,3181,6771,0.47,568,1464,0.388,2613,5307,0.492,1405,1855,0.757,958,2598,3556,1870,684,421,1258,1511,8335
2013,Dallas Mavericks,82,19980,3067,6890,0.445,642,1789,0.359,2425,5101,0.475,1566,2079,0.753,985,2752,3737,1805,698,340,1202,1547,8342
2013,Houston Rockets*,82,19780,3184,7007,0.454,661,1798,0.368,2523,5209,0.484,1374,1771,0.776,876,2539,3415,1858,693,498,1210,1674,8403
2013,Charlotte Bobcats,82,19805,3185,6762,0.471,716,1847,0.388,2469,4915,0.502,1332,1784,0.747,971,2645,3616,2071,569,565,1152,1746,8418
2013,Sacramento Kings,82,19830,3222,6831,0.472,625,1762,0.355,2597,5069,0.512,1550,1980,0.783,973,2601,3574,2058,624,517,1208,1636,8619
2012,Chicago Bulls*,66,15940,2284,5420,0.421,305,939,0.325,1979,4481,0.442,946,1279,0.74,750,1889,2639,1245,490,343,876,1166,5819
2012,Boston Celtics*,66,15940,2207,5262,0.419,344,1117,0.308,1863,4145,0.449,1138,1498,0.76,781,2070,2851,1233,515,304,1035,1217,5896
2012,Philadelphia 76ers*,66,15915,2263,5302,0.427,357,1070,0.334,1906,4232,0.45,1017,1352,0.752,706,2181,2887,1293,391,316,918,1070,5900
2012,Miami Heat*,66,16040,2285,5267,0.434,479,1318,0.363,1806,3949,0.457,1056,1457,0.725,727,1897,2624,1297,549,280,1107,1356,6105
2012,Memphis Grizzlies*,66,15940,2278,5132,0.444,417,1209,0.345,1861,3923,0.474,1163,1522,0.764,729,1954,2683,1274,518,363,1130,1275,6136
2012,Atlanta Hawks*,66,16165,2380,5366,0.444,391,1137,0.344,1989,4229,0.47,997,1324,0.753,712,2079,2791,1354,494,313,999,1263,6148
2012,Orlando Magic*,66,15965,2372,5287,0.449,414,1192,0.347,1958,4095,0.478,1005,1302,0.772,667,2061,2728,1350,495,273,867,1308,6163
2012,New Orleans Hornets,66,15940,2305,5188,0.444,425,1342,0.317,1880,3846,0.489,1129,1487,0.759,731,1910,2641,1379,523,380,915,1235,6164
2012,Toronto Raptors,66,15965,2234,5130,0.435,401,1224,0.328,1833,3906,0.469,1335,1795,0.744,677,1997,2674,1327,478,322,870,1214,6204
2012,Indiana Pacers*,66,15990,2305,5304,0.435,442,1259,0.351,1863,4045,0.461,1179,1617,0.729,794,1998,2792,1292,433,398,985,1428,6231
2012,New York Knicks*,66,15940,2316,5238,0.442,444,1238,0.359,1872,4000,0.468,1171,1590,0.736,717,2045,2762,1248,536,334,1125,1437,6247
2012,Dallas Mavericks*,66,16065,2347,5390,0.435,473,1368,0.346,1874,4022,0.466,1092,1456,0.75,725,2173,2898,1351,561,265,971,1213,6259
2012,Los Angeles Clippers*,66,15965,2279,5098,0.447,460,1261,0.365,1819,3837,0.474,1251,1678,0.746,712,1914,2626,1368,396,296,966,1401,6269
2012,Detroit Pistons,66,15965,2378,5147,0.462,395,1114,0.355,1983,4033,0.492,1162,1518,0.765,703,1985,2688,1485,563,348,959,1283,6313
2012,Los Angeles Lakers*,66,16065,2492,5703,0.437,443,1274,0.348,2049,4429,0.463,901,1215,0.742,758,1946,2704,1446,556,302,745,1332,6328
2012,San Antonio Spurs*,66,15940,2512,5560,0.452,412,1166,0.353,2100,4394,0.478,932,1233,0.756,680,2039,2719,1291,489,330,906,1244,6368
2012,Oklahoma City Thunder*,66,15990,2405,5629,0.427,421,1231,0.342,1984,4398,0.451,1167,1519,0.768,835,1889,2724,1312,542,321,937,1322,6398
2012,Portland Trail Blazers,66,15965,2476,5349,0.463,442,1217,0.363,2034,4132,0.492,1062,1421,0.747,730,2062,2792,1392,499,314,982,1306,6456
2012,Houston Rockets,66,16065,2474,5427,0.456,369,1136,0.325,2105,4291,0.491,1142,1490,0.766,729,2027,2756,1321,495,340,972,1215,6459
2012,Washington Wizards,66,15865,2422,5352,0.453,426,1216,0.35,1996,4136,0.483,1227,1618,0.758,811,2062,2873,1420,520,300,1004,1231,6497
2012,Phoenix Suns,66,15840,2505,5510,0.455,398,1131,0.352,2107,4379,0.481,1100,1444,0.762,802,2064,2866,1416,526,288,929,1293,6508
2012,Milwaukee Bucks,66,15865,2449,5453,0.449,438,1247,0.351,2011,4206,0.478,1181,1535,0.769,813,2138,2951,1433,499,297,1049,1278,6517
2012,Utah Jazz*,66,16165,2403,5310,0.453,428,1259,0.34,1975,4051,0.488,1302,1727,0.754,728,1988,2716,1355,494,375,968,1366,6536
2012,New Jersey Nets,66,15890,2501,5294,0.472,431,1151,0.374,2070,4143,0.5,1106,1494,0.74,780,2032,2812,1539,525,330,943,1274,6539
2012,Minnesota Timberwolves,66,15940,2572,5656,0.455,406,1195,0.34,2166,4461,0.486,1059,1402,0.755,771,2096,2867,1422,549,377,875,1435,6609
2012,Cleveland Cavaliers,66,15965,2536,5431,0.467,448,1236,0.362,2088,4195,0.498,1095,1464,0.748,752,2073,2825,1527,524,409,917,1381,6615
2012,Charlotte Bobcats,66,15890,2568,5411,0.475,406,1142,0.356,2162,4269,0.506,1115,1486,0.75,778,2193,2971,1537,499,378,890,1341,6657
2012,Golden State Warriors,66,15915,2461,5431,0.453,468,1281,0.365,1993,4150,0.48,1288,1725,0.747,869,2157,3026,1527,499,328,978,1095,6678
2012,Denver Nuggets*,66,16040,2541,5569,0.456,571,1489,0.383,1970,4080,0.483,1029,1356,0.759,730,1928,2658,1528,524,439,1028,1452,6682
2012,Sacramento Kings,66,15915,2668,5609,0.476,439,1236,0.355,2229,4373,0.51,1118,1468,0.762,815,2154,2969,1571,518,423,1014,1313,6893
2011,Boston Celtics*,82,19780,2768,6371,0.434,443,1304,0.34,2325,5067,0.459,1494,1975,0.756,862,2387,3249,1533,574,364,1262,1659,7473
2011,Chicago Bulls*,82,19830,2805,6523,0.43,427,1308,0.326,2378,5215,0.456,1450,1898,0.764,828,2322,3150,1556,568,477,1159,1645,7487
2011,Milwaukee Bucks,82,19830,2834,6342,0.447,437,1309,0.334,2397,5033,0.476,1498,1946,0.77,836,2629,3465,1657,507,392,1245,1694,7603
2011,Orlando Magic*,82,19830,2865,6569,0.436,516,1476,0.35,2349,5093,0.461,1441,1940,0.743,805,2450,3255,1646,606,310,1136,1791,7687
2011,New Orleans Hornets*,82,19830,2882,6306,0.457,557,1562,0.357,2325,4744,0.49,1390,1805,0.77,769,2457,3226,1739,497,396,1192,1674,7711
2011,Miami Heat*,82,19780,2869,6614,0.434,546,1584,0.345,2323,5030,0.462,1473,1980,0.744,864,2349,3213,1651,574,246,1081,1788,7757
2011,Portland Trail Blazers*,82,19805,2904,6218,0.467,529,1440,0.367,2375,4778,0.497,1434,1869,0.767,868,2385,3253,1573,566,339,1286,1743,7771
2011,Los Angeles Lakers*,82,19830,3008,6888,0.437,558,1668,0.335,2450,5220,0.469,1246,1628,0.765,1002,2399,3401,1827,585,372,1116,1700,7820
2011,Atlanta Hawks*,82,19730,3009,6537,0.46,459,1358,0.338,2550,5179,0.492,1380,1782,0.774,839,2488,3327,1751,548,348,1026,1517,7857
2011,Dallas Mavericks*,82,19705,2996,6656,0.45,508,1480,0.343,2488,5176,0.481,1373,1830,0.75,880,2459,3339,1689,623,303,1114,1650,7873
2011,Charlotte Bobcats,82,19805,2956,6492,0.455,577,1609,0.359,2379,4883,0.487,1489,1908,0.78,804,2446,3250,1777,601,496,1082,1730,7978
2011,Philadelphia 76ers*,82,19930,2996,6638,0.451,468,1375,0.34,2528,5263,0.48,1536,1987,0.773,881,2608,3489,1762,583,376,1168,1544,7996
2011,Memphis Grizzlies*,82,19880,2967,6489,0.457,587,1592,0.369,2380,4897,0.486,1482,1948,0.761,905,2387,3292,1724,613,505,1367,1754,8003
2011,San Antonio Spurs*,82,19780,3127,6860,0.456,479,1305,0.367,2648,5555,0.477,1301,1698,0.766,884,2494,3378,1685,567,374,1095,1701,8034
2011,New Jersey Nets,82,20005,3069,6602,0.465,507,1393,0.364,2562,5209,0.492,1589,2115,0.751,849,2575,3424,1824,561,375,1010,1638,8234
2011,Detroit Pistons,82,19880,3110,6405,0.486,523,1461,0.358,2587,4944,0.523,1503,1962,0.766,866,2470,3336,1910,568,381,1160,1545,8246
2011,Indiana Pacers*,82,19780,3071,6837,0.449,511,1423,0.359,2560,5414,0.473,1618,2157,0.75,931,2618,3549,1670,615,467,1143,1758,8271
2011,Oklahoma City Thunder*,82,20005,3123,6823,0.458,482,1335,0.361,2641,5488,0.481,1557,2093,0.744,932,2395,3327,1712,587,356,1152,1767,8285
2011,Utah Jazz,82,19880,2967,6460,0.459,592,1573,0.376,2375,4887,0.486,1777,2285,0.778,925,2426,3351,1700,609,411,1199,1802,8303
2011,Los Angeles Clippers,82,19855,3046,6688,0.455,584,1598,0.365,2462,5090,0.484,1670,2167,0.771,914,2410,3324,1827,659,404,1125,1811,8346
2011,Denver Nuggets*,82,19705,3153,6876,0.459,576,1675,0.344,2577,5201,0.495,1539,2036,0.756,864,2525,3389,1820,611,488,1127,1864,8421
2011,Houston Rockets,82,19880,3266,6979,0.468,448,1250,0.358,2818,5729,0.492,1526,1954,0.781,955,2552,3507,1707,588,449,1125,1754,8506
2011,Cleveland Cavaliers,82,19755,3232,6804,0.475,664,1614,0.411,2568,5190,0.495,1438,1894,0.759,894,2676,3570,1984,619,489,1111,1747,8566
2011,Washington Wizards,82,19930,3174,6741,0.471,560,1500,0.373,2614,5241,0.499,1676,2202,0.761,994,2607,3601,1898,624,413,1293,1662,8584
2011,Sacramento Kings,82,19855,3260,6826,0.478,480,1353,0.355,2780,5473,0.508,1589,2085,0.762,868,2508,3376,1779,666,464,1204,1723,8589
2011,Toronto Raptors,82,19780,3213,6668,0.482,541,1438,0.376,2672,5230,0.511,1672,2175,0.769,912,2457,3369,1854,625,456,1141,1620,8639
2011,Golden State Warriors,82,19830,3173,6788,0.467,567,1586,0.358,2606,5202,0.501,1755,2262,0.776,1051,2623,3674,2029,672,352,1324,1512,8668
2011,New York Knicks*,82,19780,3242,6870,0.472,536,1442,0.372,2706,5428,0.499,1650,2165,0.762,964,2646,3610,1682,586,360,1250,1703,8670
2011,Phoenix Suns,82,20005,3309,7018,0.472,585,1595,0.367,2724,5423,0.502,1481,1964,0.754,985,2647,3632,1890,644,356,1189,1740,8684
2011,Minnesota Timberwolves,82,19780,3230,6902,0.468,639,1707,0.374,2591,5195,0.499,1733,2227,0.778,913,2577,3490,2031,777,447,1183,1717,8832
2010,Charlotte Bobcats*,82,19880,2925,6536,0.448,573,1696,0.338,2352,4840,0.486,1270,1710,0.743,868,2382,3250,1666,614,502,1256,1804,7693
2010,Miami Heat*,82,19880,2813,6408,0.439,524,1531,0.342,2289,4877,0.469,1577,2091,0.754,856,2483,3339,1545,517,355,1184,1639,7727
2010,Portland Trail Blazers*,82,19855,2950,6352,0.464,480,1399,0.343,2470,4953,0.499,1394,1870,0.745,801,2322,3123,1583,485,333,1104,1767,7774
2010,Orlando Magic*,82,19730,2955,6739,0.438,522,1437,0.363,2433,5302,0.459,1380,1830,0.754,800,2481,3281,1550,551,288,1050,1819,7812
2010,Boston Celtics*,82,19780,2880,6390,0.451,470,1375,0.342,2410,5015,0.481,1606,2152,0.746,868,2418,3286,1585,578,386,1283,1777,7836
2010,Cleveland Cavaliers*,82,19780,2935,6633,0.442,524,1511,0.347,2411,5122,0.471,1444,1907,0.757,794,2366,3160,1661,542,325,1045,1708,7838
2010,Milwaukee Bucks*,82,19980,2870,6361,0.451,438,1276,0.343,2432,5085,0.478,1692,2211,0.765,790,2722,3512,1581,573,421,1254,1664,7870
2010,San Antonio Spurs*,82,19780,3025,6691,0.452,412,1200,0.343,2613,5491,0.476,1433,1896,0.756,814,2427,3241,1576,567,417,1032,1672,7895
2010,Los Angeles Lakers*,82,19830,3050,6840,0.446,520,1585,0.328,2530,5255,0.481,1332,1776,0.75,914,2546,3460,1792,573,363,1159,1737,7952
2010,Atlanta Hawks*,82,19855,3048,6623,0.46,480,1392,0.345,2568,5231,0.491,1380,1852,0.745,922,2471,3393,1719,506,359,1135,1582,7956
2010,Oklahoma City Thunder*,82,19805,3007,6718,0.448,481,1414,0.34,2526,5304,0.476,1541,2018,0.764,937,2397,3334,1618,616,384,1238,1755,8036
2010,Utah Jazz*,82,19755,2908,6471,0.449,552,1559,0.354,2356,4912,0.48,1741,2286,0.762,837,2376,3213,1628,632,445,1238,1818,8109
2010,Chicago Bulls*,82,19905,3043,6885,0.442,584,1680,0.348,2459,5205,0.472,1457,1958,0.744,916,2589,3505,1715,578,438,1090,1643,8127
2010,Detroit Pistons,82,19780,2965,6172,0.48,568,1514,0.375,2397,4658,0.515,1630,2124,0.767,814,2420,3234,1898,549,401,1174,1702,8128
2010,Dallas Mavericks*,82,19880,3107,6805,0.457,525,1515,0.347,2582,5290,0.488,1402,1849,0.758,922,2592,3514,1659,563,337,1195,1652,8141
2010,Washington Wizards,82,19830,3083,6664,0.463,528,1466,0.36,2555,5198,0.492,1590,2088,0.761,935,2530,3465,1772,569,415,1115,1684,8284
2010,New Jersey Nets,82,19780,3172,6593,0.481,468,1278,0.366,2704,5315,0.509,1511,2021,0.748,925,2683,3608,1960,638,421,1149,1647,8323
2010,Philadelphia 76ers,82,19805,3105,6573,0.472,606,1542,0.393,2499,5031,0.497,1518,1983,0.766,888,2470,3358,1810,621,332,1189,1534,8334
2010,Los Angeles Clippers,82,19705,3193,6792,0.47,529,1457,0.363,2664,5335,0.499,1455,1910,0.762,879,2490,3369,1926,686,363,1059,1588,8370
2010,Denver Nuggets*,82,19780,3088,6766,0.456,523,1498,0.349,2565,5268,0.487,1695,2207,0.768,955,2513,3468,1723,578,438,1235,1943,8394
2010,New Orleans Hornets,82,19830,3250,6730,0.483,539,1517,0.355,2711,5213,0.52,1383,1841,0.751,870,2586,3456,1925,574,367,1177,1597,8422
2010,Houston Rockets,82,19905,3236,6810,0.475,489,1344,0.364,2747,5466,0.503,1464,1917,0.764,875,2632,3507,1716,597,532,1207,1840,8425
2010,Indiana Pacers,82,19705,3113,6875,0.453,510,1405,0.363,2603,5470,0.476,1774,2346,0.756,969,2852,3821,1694,654,414,1227,1709,8510
2010,Memphis Grizzlies,82,19905,3277,6849,0.478,572,1618,0.354,2705,5231,0.517,1402,1858,0.755,907,2349,3256,1875,635,501,1165,1840,8528
2010,Sacramento Kings,82,19880,3199,6828,0.469,497,1391,0.357,2702,5437,0.497,1663,2149,0.774,909,2538,3447,1683,586,468,1120,1650,8558
2010,Phoenix Suns*,82,19730,3235,7165,0.452,561,1582,0.355,2674,5583,0.479,1606,2114,0.76,1081,2391,3472,1704,646,365,1065,1789,8637
2010,Toronto Raptors,82,19780,3194,6824,0.468,609,1665,0.366,2585,5159,0.501,1683,2146,0.784,933,2453,3386,1889,580,360,1040,1730,8680
2010,New York Knicks,82,19880,3352,6902,0.486,553,1571,0.352,2799,5331,0.525,1429,1896,0.754,959,2724,3683,1723,585,368,1182,1576,8686
2010,Minnesota Timberwolves,82,19780,3343,6961,0.48,618,1690,0.366,2725,5271,0.517,1534,1981,0.774,917,2640,3557,2103,721,442,1173,1686,8838
2010,Golden State Warriors,82,19730,3409,7033,0.485,567,1514,0.375,2842,5519,0.515,1832,2390,0.767,1100,2842,3942,1979,645,407,1442,1757,9217
